****************
*         *   E*
*    *    *   **
*       * * *  *
*  * *         *
*  * *    *    *
*S   *         *
****************
