****************
* E            *
*    ******   **
******   ****  *
*  * *         *
******    *    *
*    *         *
*         *    *
******    *   **
*       * * *  *
****           *
******    *    *
* S      *     *
****************
